###########################################################
]  %B %   % ####### %     %  %B %     ########%  B %     A#
#  ######    #   %   #######   ######%#      #   %%###   ##
#  #    #%   # %% #   %   # % B     # #  % % #     # %  % #
# %% %  #  % # #  ######### ####### # # ### ### #  # ###  #
#%#  #     % # #      %     B  %    # # #     # #  # %    #
# %  ######%### ########## #######%### # % % # #  ####### #
# #        % # %   B  %  #     %    #  ####### ####%    # #
# #  ##%##### ########## ### ####### ####     #    % %% # #
# %  B  A   #    %  B %   # %     %  B  %  %  # ######### #
# ##%##% % ########%%##############%#######%##    %   %   #
# #    #   %  # B      %    #   %    %     #   ########## #
# # %% ###### # #########%## ######### ### # % #  B B   % #
# #  %     %  #     A     %     B %  B  # % # # ###########
# # % ###% %########%#################%###% # #    %    % #
#B#   #   %   %   %   A    %     %  B  %    # ## %   % %  #
###### # % ##### ###%### ######%#####%###%### ##########% #
#     # % # B % #     %     %    # %     %    #   %   #   #
########### %% #####%#####%####### ########### %% %%% # B #
/ %     %B%  %     %B%      %   %     %      %%    %   %  #
###########################################################
