#####################################
#                                   #
#                .                  #
#              .---.                #
#          |--|     |--/            #
#              \---/                #
#                                   #
#                                   #
#                                   #
]                                   /
#####################################