###########################################
#AA                                     AA#
#A                                       A#
#                                         #
#                                         #
#                                         #
#                                         #
#                                         #
#                                         #
#                                         #
]                                         /
###########################################