#####################################
#             _____                 #
#            (- _ -)                #
#            -|   |-                #
#             /---                  #
#            /                      #
#                                   #
#                                   #
#                                   #
]                                   /
#####################################