########################################
#AA              _____               AA#
#A              (- _ -)               A#
#               -|   |-                #
#                g---                  #
#               g                      #
#                                      #
#                                      #
#                                      #
#                                      #
]                                      /
########################################