#####################################
#AA                               AA#
#A               .                 A#
#              .---.                #
#          |--|     |--g            #
#              \---g                #
#                                   #
#                                   #
#                                   #
#                                   #
]                                   /
#####################################