##########################################################
]  %   %B   %    %   %%    %   %  A#    %    B   %     % #
#   %%     %%     %   %%   B     ##  %     %     %   %%  #
#  ######%%%%##########%%%%##########%%%%#######%%%%%%%  #
#  #    %   %  #    %  # B     %  #   %     #     B    # #
#  # %  %     #  %  #    %   %   #  %   %   #   %%     # #
#  #   B % B  #     #   %    %   #      %   #       #### #
#  ####%%%%%%####%%%%##%%%%########%%%%%%#     %     %   #
#  #    %  %  #    %    %  #  B    %   %  #   %    %     #
#B # %B%   %  #  A    A    #   %  A    %  #     B    %   #
#%%#########%%##########%%#########%%%%%%%######%%#####%%#
#        #  A  A  %     ~~~~~~~~%     # %   %     %   %  #
# %      #  A     %     ~~~~~~~~     #     %    B   %    #
# %%     ##############################################  #
# %     #  A     %   B     %     %     #   %   %    %    #
#  %    ######%%#####   %%     %  %    #   ######        #
#   %   #   %     # A   %  A#   %    %  #        #   %   #
## %    #   A  % B  %   %    #   %  %   #      % #    %###
#   B   % A    %%  # % #% B%##%%   %       B%   %     %  /
##########################################################
