##############################
#                            #
#       Bienvenido a         #
#      LA TORRE DE LEUGIM    #
#            ]               #
#                            #
##############################
