###################################
#      `,' |    ___    |   ,'`    #
#      ',  |   [_^_]   |  ',      #
D       V  |___________|   V      #
#           '---------'           #
#                                 #
#                                 #
#                                 #
#                                 #
###################################