##########################################################
#     %   %  % B % %    %  %%    %     %   %  A#    %%#  /
#  %  B %     % %%%     %   %   %%  %     %     %    %##%#
#%% ###########%%#####################%%######%##%%###   #
# % #  %   %   # %   %     % #   %      #  %      #   %  #
#%  #   %  %   #   %  %   # %   %% %%%  #  %%  %  #   ## #
#%% #########%%#######%###########%%###%  %     # %     %#
# % #       % #     B   # %    %     %     %%%  #  %   # #
#   #   B %   #   A     #   %    A   %   B   %   #   % # #
#  #########%%#####%###%#  ~~~  #%%#######%###########   #
#        #   A    A   %   ~~~~~    #    %   %   %  %     #
#  %     #   A  B %   %    ~~~  %  # %   % %    B        #
#%%    ################%%############%#################  #
# %    #A  %   B  %      # %   %     A#  %  %       %   %#
#   %     ########%##%###%  %%   %    #      ######      #
#  ##   %     %     # A %   A#     %  #      #     %  %  #
## ##   A   B    % % %   %   # % %    %      #      %    #
#B #]  %A    %%%  #     #%  %##%%  %%   B     %     %   B#
##########################################################
