####################################################################################################################
#                               |                       |                          |                               #
#                               |                       |                          |                               #
#                               |                       |                          |                               #
#                               |                       |                          |                               #
#                               ]                       ]                          |                               #
#                               |                       |                          |                               #---|
]                               |                       |                          |                               E   |
]                               |-----------------------|                          ]                               E   |
]                               |                       |                          |                               #---|
#                               |                       |                          |                               #
#                               ]                       ]                          |                               #
#                               |                       |                          |                               #
#                               |                       |                          |                               #
#                               |                       |                          |                               #
#                               |                       |                          |                               #
####################################################################################################################

