####################################################################################################################
#                               |                       |                          |                               #
#                               |                       |                          |                               #
#                               |                       |                          |                               #
#                               |                       |                          |                               #
#                               ]                       ]                          |                               #
#                               |                       |                          |                               #
]                               |                       |                          |                               E
]                               |-----------------------|                          ]                               E
]                               |                       |                          |                               E
#                               |                       |                          |                               #
#                               ]                       ]                          |                               #
#                               |                       |                          |                               #
#                               |                       |                          |                               #
#                               |                       |                          |                               #
#                               |                       |                          |                               #
####################################################################################################################

