#########################################################
#        |            |               |                 #
#        ]            ]               |                 #
]        |------------|               ]                 E
#        ]            ]               |                 #
#        |            |               |                 #
#########################################################
