#########################################################
#        |            |               |                 #
#        ]            ]               |                 #
]        |------------|               ]                 #
#        ]            ]               |                 #
#        |            |               |                 #
#--------|-------------------]--------------------------#                       
#        |                                 |            #
#        ]                                 ]            #
#        |                                 |            #
#--------|---------------------------------|            E                  
#        |              ]                  |            #
#        ]              |-------]----------|            #
#        |              |                               #
#########################################################
