#########################################################
#   %  %   B   %   %%   %   %%   %  %   %   B    %   %  #
# %%#%###%#####%#######%######%###%###%###%######%###%# #
# %    #     %  B  %      %     %     %    %     %    % #
# #%#%#####%#####%###%###%#%###%#####%###%#%###%###%###%#
# %  % # #  B  %  #   %  %  B  #  %   %  #    %   #  %  #
#####%###%#######%###%###%######%###%###%###%###%###%## #
#]     #%   B    %   %    %    %     %     %    %   %   #
#########%#####%#########%######%#####%#######%######## #
#   %   % B   %  %  %   %     %   %   %    %  %     %  ##
# %###%#####%###%###%###%######%###%###%###%###%###%###%#
# %  %    %     %   B  %  %  %   %    %     %    %     %#
# #######%##########%##########%###########%%############
#  # % B   A  %    ~~~~~~~~    %  # A    %    %   %   % #
#  # %#######%#### ~~~~~~~~  %###########%%#######%###% #
#  #    % B  %     ~~~~~~~~ B  % A  #   %  B    %     % #
# #######%###%###################%###########%#####%#####
#  #   %    # %   B    %    %    #B    %     %   #   %  #
#  # %#####%###%########%#######%#######%#####%###%%#####
# B#  %    %    %   B   %  %   %   %  %    % B  %     % /
#########################################################
