###################################
#      `,' |    ___    |   ,'`    #
#      ',  |   |_._|   |  ',      #
#       V  |           |   V      #
#           |---------|           #
#            '-------'            #
]                                 #
#                                 /
#                                 #
###################################