###################################
#      `,' |    ___    |   ,'`    #
#      ',  |   [_^_]   |  ',      #
#       V  |___________|   V      #
#           '---------'           #
]                                 /
#                                 #
#                                 #
#                                 #
###################################