______________________________________________
|                                            |
|                                            |
|                                            |
|                                            |
|           | 1 |    | 2 |    | 3 |          |
|           -----    -----    -----          |
|                                            |
|                                            |
|                                            |
______________________________________________