##########################################################
]  %  %B %    %  %   %%  %     % % %     B %   %  % % %  #
###%###%#######%#######%#######%#####%#######%######%### #
#  %   #     %     %     %   %   # %     %     %  %   #  #
# %%#% #######%###%###%#####%#%#######%#########%##%#%#% #
# % #     %     # %   %  B  %  #   %  %   % %     %  # % #
# ###%########%#%#%#######%###%#%###%###%###%########%# ##
# %     % B%    #    %   %     #   %  B  %     %   %     #
# ###########%#######%#####%#%#######%#######%########## #
#   %     %   #     %   %   %     %   # %     %    %    ##
# %#%#####%#%#%#######%#######%#######%#%#######%#######%#
# %  %     %    %  B  % %  %   %    %    %     %     %   #
# ########%##########%##########%###########%%############ 
# # %  % B A    %    ~~~~~~~    %    A   %     %  %  %   #
# # %#####%#######%  ~~~~~~~  %###########%%#######%###% #
# #   %  B A   %     ~~~~~~~     % A     %   B   %     % #
# ######%#####%#####################%###########%#####% ##
# #   %  B  # %    B     %    %     #     %   %  #   %   #
# # %%#####%###%########%#######%#######%#####%###%%#### #
#B# B  %    %    %   B   %  %   %   %  %    %     %  %   /
##########################################################
